axisem = Kasra Hosseini <hosseini@geophysik.uni-muenchen.de>
colombia@D.ETHZ.CH = Andree Colombi <andree.colombi@gmail.com>
kasra = Kasra Hosseini <hosseini@geophysik.uni-muenchen.de>
staehler = Simon Staehler <staehler@geophysik.uni-muenchen.de>
tarjen@D.ETHZ.CH = Tarje Nissen-Meyer <tarjen@earth.ox.ac.uk>
vamartin@D.ETHZ.CH = Martin van Driel <vandriel@erdw.ethz.ch>
allmaras = Moritz Allmaras <allmaras@math.tamu.edu>
bangerth = Wolfgang Bangerth <bangerth@math.tamu.edu>
buerg = Markus Bürg <buerg@math.tamu.edu>
dannberg = Juliane Dannberg <dannberg@gfz-potsdam.de>
gassmoeller = Rene Gassmoeller <rengas@gfz-potsdam.de>
geenen = Thomas Geenen <geenen@gmail.com>
heien = Eric Heien <emheien@ucdavis.edu>
heister = Timo Heister <heister@math.tamu.edu>
kronbichler = Martin Kronbichler <martin.kronbichler@it.uu.se>
ryan.grove = Ryan Grove <ryan.grove>
s-wang = Shuqiang Wang <shuqiangwang@gmail.com>
turcksin = Bruno Turcksin <bruno.turcksin@gmail.com>
aivazis = Michael Aivazis <aivazis@caltech.edu>
alessia = Alessia Maggi <alessia.maggi@unistra.fr>
alisic = Laura Alisic <alisic@gps.caltech.edu>
alex = Alex Takakuwa <alex@geodynamics.org>
ampuero = Jean Paul Ampuero <ampuero@gps.caltech.edu>
anne = Anne Sieminski <anne.sieminski@obs.ujf-grenoble.fr>
baagaard = Brad Aagaard <baagaard@usgs.gov>
becker = Thorsten Becker <twb@usc.edu>
bernhard = Bernhard Schubert <mail@bernhard-schuberth.de>
boo = Leif Strand <leif@geodynamics.org>
bozdag = Ebru Bozdag <bozdag@princeton.edu>
brad = Brad Aagaard <baagaard@usgs.gov>
braden.pellett = Braden Pellett <bpellett@ucdavis.edu>
carltape = Carl Tape <carltape@gi.alaska.edu>
cassie = Cassie Ferguson <cassie@geodynamics.org>
ces74 = Eunseo Choi <echoi@ig.utexas.edu>
cjoneill = Craig O'Neill <cjoneill@rice.edu>
cmorency = Christina Morency <morency1@llnl.gov>
cristini = Paul Cristini <cristini@lma.cnrs-mrs.fr>
cstark = Colin Stark <cstark@ldeo.columbia.edu>
danb = Dan Bower <danb@gps.caltech.edu>
danielpeter = Daniel Peter <peterda@ethz.ch>
davidmichea = David Michea <dmichea@univ-pau.fr>
dkomati1 = Dimitri Komatitsch <komatitsch@lma.cnrs-mrs.fr>
dmcr = Dennis McRitchie <dmcr@princeton.edu>
dmichea = David Michea <dmichea@univ-pau.fr>
echoi = Eun-seo Choi <echoi@ig.utexas.edu>
elliott.sales.de.andrade = Elliott Sales de Andrade <esalesde@physics.utoronto.ca>
emanuele = Emanuele Casarotti <emanuele.casarotti@gmail.com>
emheien = Eric Heien <emheien@ucdavis.edu>
ericheien = Eric Heien <emheien@ucdavis.edu>
friberg = Paul Friberg <p.friberg@isti.com>
gian = Gian Matharu <gmatharu@eos.ubc.ca>
gurnis = Michael Gurnis <gurnis@caltech.edu>
hejunzhu = Hejun Zhu <hejunzhu@Princeton.EDU>
hlin = Lijie Han <han@psi.edu>
homnath = Hom Nath Gharti <hgharti@princeton.edu>
joseph.charles = Joseph Charles <jcharles@lma.cnrs-mrs.fr>
jtromp = Jeroen Tromp <jtromp@princeton.edu>
knepley = Matt Knepley <knepley@gmail.com>
komatits = Dimitri Komatitsch <komatitsch@lma.cnrs-mrs.fr>
lcarring = Laura Carrington <lcarring@sdsc.edu>
lefebvre = Matthieu Lefebvre <ml15@princeton.edu>
leif = Leif Strand <leif@geodynamics.org>
liuqy = Qinya Liu <liuqy@physics.utoronto.ca>
lqy = Qinya Liu <liuqy@physics.utoronto.ca>
luet = David Luet <luet@princeton.edu>
luis = Luis Armendariz <luis@geodynamics.org>
maweier = Martin Weier <maweier@geodynamics.org>
mchen = Min Chen <mchen.duoduo@gmail.com>
meschede = Matthias Meschede <matthias.meschede@googlemail.com>
nlegoff = Nicolas Legoff <nicolas.legoff@univ-pau.fr>
patrick = Patrick Hung <patrickh@caltech.edu>
percygalvez = Percy Galvez <percy.galvez@sed.eth.ch>
pieyre = Pieyre Le Loher <pieyre.le-loher@inria.fr>
polson = Peter Olson <olson@jhu.edu>
puru = Puru Thoutireddy <puru@cacr.caltech.edu>
rietmann = Max Rietmann <max.rietmann@usi.ch>
rjolivet = Romain Jolivet <rjolivet@caltech.edu>
rmodrak = Ryan Modrak <rmodrak@princeton.edu>
savage13 = Brian Savage <savage13@gps.caltech.edu>
sdk = Scott King <sdk@vt.edu>
slombey = Santiago Lombeyda <slombey@cacr.caltech.edu>
steve = Steve Quenette <steve.quenette@monash.edu>
sue = Sue Kientz <sue@geodynamics.org>
svm = Leif Strand <leif@geodynamics.org>
svn = Leif Strand <leif@geodynamics.org>
surendra = Surendra Somala <surendra@caltech.edu>
tan2 = Eh Tan <tan2@earth.sinica.edu.tw>
tlknight = Terry Knight <tlknight@cse.ucdavis.edu>
unknown_user = Leif Strand <leif@geodynamics.org>
vadim = Vadim Monteiller <Vadim.Monteiller@irap.omp.eu>
vala = Vala Hjörleifsdóttir <vala@gps.caltech.edu>
vlad = Vlad Manea <vlad@geociencias.unam.mx>
walter = Walter Landry <walter@geodynamics.org>
wei = Wei Mi <wei@geodynamics.org>
weimi = Wei Mi <wei@geodynamics.org>
willic3 = Charles Williams <C.Williams@gns.cri.nz>
xie.zhinan = Xie Zhinan <xiezhinan1984@gmail.com>
yangl = Yang Luo <yangl@princeton.edu>
yingz = Ying Zhou <yingz@vt.edu>
ykim = YoungHee Kim <ykim@gps.caltech.edu>
VCP = Leif Strand <leif@geodynamics.org>
(no author) = Leif Strand <leif@geodynamics.org>
barmin = barmin <barmin>
cigtg = cigtg <cigtg>
lis = lis <lis>
luke = luke <luke>
